,Unnamed: 0,gene_id,gene_chr,gene_start,gene_end,strand,number_of_SNPs_tested,SNP_distance_to_TSS,SNP_id,SNP_chr,SNP_start,SNP_end,nominal_pval,regression_slope,top_SNP,FDR,snps,rs_id
19166,19166,ENSG00000175582,chr11,73472182,73472182,+,3320,-16890,11:73455292,chr11,73455292,73455292,4.28048e-08,-0.0863129,0,3.86883013867483e-06,73455292,rs10898940
19308,19308,ENSG00000175582,chr11,73472182,73472182,+,3320,233082,11:73705264,chr11,73705264,73705264,7.06216e-05,0.0617845,0,0.003427119372687,73705264,rs4944873
22000,22000,ENSG00000149243,chr11,75141236,75141236,+,3064,-14506,11:75126730,chr11,75126730,75126730,0.000296068,0.0548769,0,0.0119754111977685,75126730,rs10793118
64634,64634,ENSG00000214253,chr7,100888356,100888356,+,3963,387403,7:101275759,chr7,101275759,101275759,0.00102061,0.0411624,0,0.0339451040599725,101275759,rs6965171
90300,90300,ENSG00000158161,chr1,28415207,28415207,+,2577,-104562,1:28310645,chr1,28310645,28310645,0.000511904,0.144251,0,0.0191010423793463,28310645,rs141365059
169598,169598,ENSG00000054793,chr20,50384867,50384867,+,3795,-67629,20:50317238,chr20,50317238,50317238,0.000184652,-0.0286171,0,0.0079631250411268,50317238,rs1205692
169657,169657,ENSG00000054793,chr20,50384867,50384867,+,3795,-13620,20:50371247,chr20,50371247,50371247,2.40392e-08,-0.0615115,0,2.25198601589195e-06,50371247,rs6013272
169666,169666,ENSG00000054793,chr20,50384867,50384867,+,3795,-6400,20:50378467,chr20,50378467,50378467,2.49366e-14,-0.060796,0,4.54466669906525e-12,50378467,rs6021422
169667,169667,ENSG00000054793,chr20,50384867,50384867,+,3795,-6187,20:50378680,chr20,50378680,50378680,1.55619e-09,-0.0520044,0,1.711825484048e-07,50378680,rs12624744
169670,169670,ENSG00000054793,chr20,50384867,50384867,+,3795,-4505,20:50380362,chr20,50380362,50380362,8.12611e-09,-0.0502823,0,8.12669647856835e-07,50380362,rs59762781
196621,196621,ENSG00000131149,chr16,85645015,85645015,+,5162,643249,16:86288264,chr16,86288264,86288264,0.000894788,-0.101782,0,0.0304641142451531,86288264,rs141852794
205392,205392,ENSG00000101255,chr20,361261,361261,+,2849,-11955,20:349306,chr20,349306,349306,6.49869e-19,0.180031,0,1.72625082515376e-16,349306,rs4813620
205434,205434,ENSG00000101255,chr20,361261,361261,+,2849,1685,20:362946,chr20,362946,362946,6.15312e-10,0.184253,0,7.13062175162351e-08,362946,rs11698936
205438,205438,ENSG00000101255,chr20,361261,361261,+,2849,4572,20:365833,chr20,365833,365833,7.47187e-07,-0.114887,0,5.51106741410665e-05,365833,rs6107242
205439,205439,ENSG00000101255,chr20,361261,361261,+,2849,13946,20:375207,chr20,375207,375207,0.000182643,0.110259,0,0.0078879807738692,375207,rs6051663
205440,205440,ENSG00000101255,chr20,361261,361261,+,2849,20977,20:382238,chr20,382238,382238,0.000175296,0.129581,0,0.0076116516136803,382238,rs148351703
205452,205452,ENSG00000101255,chr20,361261,361261,+,2849,183156,20:544417,chr20,544417,544417,0.000920333,0.0691485,0,0.0311759026284255,544417,rs13043344
205458,205458,ENSG00000125826,chr20,388142,388142,+,2901,-22309,20:365833,chr20,365833,365833,8.96822e-06,0.0759868,0,0.0005367665049581,365833,rs6107242
205460,205460,ENSG00000125826,chr20,388142,388142,+,2901,-7540,20:380602,chr20,380602,380602,0.00116536,0.0463451,0,0.0378133762169731,380602,rs6084326
205462,205462,ENSG00000125826,chr20,388142,388142,+,2901,-4896,20:383246,chr20,383246,383246,0.000228073,-0.091989,0,0.0095643046199768,383246,rs6115847
205465,205465,ENSG00000125826,chr20,388142,388142,+,2901,-1678,20:386464,chr20,386464,386464,0.00014905,-0.0510388,0,0.006610397754083,386464,rs6115856
205467,205467,ENSG00000125826,chr20,388142,388142,+,2901,4593,20:392735,chr20,392735,392735,0.000232457,-0.0913472,0,0.0097226573279113,392735,rs67040509
205468,205468,ENSG00000125826,chr20,388142,388142,+,2901,5836,20:393978,chr20,393978,393978,1.27024e-25,-0.170356,1,5.1472885275674e-23,393978,rs1358782
205473,205473,ENSG00000125826,chr20,388142,388142,+,2901,11687,20:399829,chr20,399829,399829,5.48609e-05,-0.0830882,0,0.0027404163011204,399829,rs57454310
205484,205484,ENSG00000125826,chr20,388142,388142,+,2901,41580,20:429722,chr20,429722,429722,1.66822e-06,0.0883379,0,0.0001153926227043,429722,rs35381164
205487,205487,ENSG00000125826,chr20,388142,388142,+,2901,191661,20:579803,chr20,579803,579803,0.00117821,0.124912,0,0.0381494898007428,579803,rs9680067
209837,209837,ENSG00000148225,chr9,116102549,116102549,+,3977,-186679,9:115915870,chr9,115915870,115915870,1.23974e-05,-0.172143,0,0.0007198060868696,115915870,rs10981653
251785,251785,ENSG00000099282,chr10,71211229,71211229,+,4660,-32385,10:71178844,chr10,71178844,71178844,2.15912e-08,0.0593138,0,2.036285e-06,71178844,rs35692332
251961,251961,ENSG00000099282,chr10,71211229,71211229,+,4660,68355,10:71279584,chr10,71279584,71279584,6.50606e-06,-0.0774728,0,0.0004008353,71279584,rs12785161
264017,264017,ENSG00000185272,chr21,15588451,15588451,+,3151,5044,21:15593495,chr21,15593495,15593495,0.000608531,-0.0541728,0,0.02209502,15593495,rs378280
264036,264036,ENSG00000185272,chr21,15588451,15588451,+,3151,17177,21:15605628,chr21,15605628,15605628,0.000610862,0.0481346,0,0.0221666,15605628,rs2822470
264048,264048,ENSG00000185272,chr21,15588451,15588451,+,3151,65748,21:15654199,chr21,15654199,15654199,0.000166183,0.0535883,0,0.007267313,15654199,rs11701684
264054,264054,ENSG00000185272,chr21,15588451,15588451,+,3151,143455,21:15731906,chr21,15731906,15731906,0.00126215,-0.0448791,0,0.04033718,15731906,rs2822627
264064,264064,ENSG00000185272,chr21,15588451,15588451,+,3151,170527,21:15758978,chr21,15758978,15758978,0.00111894,-0.0439201,0,0.03658914,15758978,rs2822650
264067,264067,ENSG00000185272,chr21,15588451,15588451,+,3151,178765,21:15767216,chr21,15767216,15767216,0.000731128,-0.054193,0,0.02575833,15767216,rs2822656
320074,320074,ENSG00000133101,chr13,37006040,37006040,+,3997,-86101,13:36919939,chr13,36919939,36919939,2.33475e-05,-0.0622565,0,0.001274703,36919939,rs4941833
320091,320091,ENSG00000133101,chr13,37006040,37006040,+,3997,243002,13:37249042,chr13,37249042,37249042,0.000526825,0.0352006,0,0.01957055,37249042,rs9531977
432956,432956,ENSG00000127445,chr19,9945933,9945933,+,3980,-925780,19:9020153,chr19,9020153,9020153,0.000539244,-0.0480589,0,0.01995738,9020153,rs75217292
432957,432957,ENSG00000127445,chr19,9945933,9945933,+,3980,-842372,19:9103561,chr19,9103561,9103561,0.00153784,-0.0356562,0,0.04727007,9103561,rs8101409
496500,496500,ENSG00000144711,chr3,13009168,13009168,+,4065,-63510,3:12945658,chr3,12945658,12945658,0.000873938,-0.0258602,0,0.02987741,12945658,rs892281
496516,496516,ENSG00000144711,chr3,13009168,13009168,+,4065,100756,3:13109924,chr3,13109924,13109924,0.000339472,-0.0262793,0,0.01347103,13109924,rs360859
496531,496531,ENSG00000144711,chr3,13009168,13009168,+,4065,331303,3:13340471,chr3,13340471,13340471,0.00140041,-0.0272056,0,0.04385725,13340471,rs9837061
496535,496535,ENSG00000144711,chr3,13009168,13009168,+,4065,344550,3:13353718,chr3,13353718,13353718,0.00117895,-0.0318538,0,0.03816872,13353718,rs113768892
510258,510258,ENSG00000166582,chr17,16248056,16248056,+,3328,-479792,17:15768264,chr17,15768264,15768264,0.000451928,-0.160582,0,0.0171907,15768264,rs149038043
510683,510683,ENSG00000166582,chr17,16248056,16248056,+,3328,15626,17:16263682,chr17,16263682,16263682,1.6977999999999998e-50,-0.29294,0,1.909161e-47,16263682,rs62074224
510726,510726,ENSG00000166582,chr17,16248056,16248056,+,3328,61398,17:16309454,chr17,16309454,16309454,9.34327e-11,0.144623,0,1.195097e-08,16309454,rs113741660
510728,510728,ENSG00000166582,chr17,16248056,16248056,+,3328,64507,17:16312563,chr17,16312563,16312563,0.000273126,0.109098,0,0.01117397,16312563,rs137934836
510741,510741,ENSG00000166582,chr17,16248056,16248056,+,3328,77453,17:16325509,chr17,16325509,16325509,5.38211e-05,-0.085358,0,0.002694152,16325509,rs9788979
510836,510836,ENSG00000166582,chr17,16248056,16248056,+,3328,624262,17:16872318,chr17,16872318,16872318,0.000986847,0.0750693,0,0.03301981,16872318,rs8075444
520107,520107,ENSG00000141480,chr17,4613784,4613784,+,4393,-234558,17:4379226,chr17,4379226,4379226,0.000185876,0.0389544,1,0.008008668,4379226,rs333135
520108,520108,ENSG00000141480,chr17,4613784,4613784,+,4393,-121860,17:4491924,chr17,4491924,4491924,0.00128416,0.0319155,0,0.04090515,4491924,rs2127227
542572,542572,ENSG00000165526,chr11,126081587,126081587,+,4262,806953,11:126888540,chr11,126888540,126888540,0.000901699,-0.0801254,0,0.03065714,126888540,rs7104043
549842,549842,ENSG00000002822,chr7,1912392,1912392,+,5550,367253,7:2279645,chr7,2279645,2279645,0.000144526,0.100088,0,0.006434329,2279645,rs62442507
561955,561955,ENSG00000127324,chr12,71835678,71835678,+,3633,-585931,12:71249747,chr12,71249747,71249747,1.75911e-07,0.105589,0,1.442421e-05,71249747,rs10784871
561995,561995,ENSG00000127324,chr12,71835678,71835678,+,3633,-539997,12:71295681,chr12,71295681,71295681,0.00104062,0.065654,0,0.03449284,71295681,rs10879217
562021,562021,ENSG00000127324,chr12,71835678,71835678,+,3633,-203735,12:71631943,chr12,71631943,71631943,0.000392452,-0.0693547,0,0.01524621,71631943,rs2904510
621978,621978,ENSG00000160862,chr7,99565216,99565216,+,2233,-113933,7:99451283,chr7,99451283,99451283,0.00115198,0.0661474,0,0.03746139,99451283,rs523265
622051,622051,ENSG00000160862,chr7,99565216,99565216,+,2233,-4350,7:99560866,chr7,99560866,99560866,2.94457e-08,0.114044,0,2.724121e-06,99560866,rs2527885
622085,622085,ENSG00000160862,chr7,99565216,99565216,+,2233,52636,7:99617852,chr7,99617852,99617852,9.83595e-08,-0.112714,0,8.402125e-06,99617852,rs35228488
622176,622176,ENSG00000160862,chr7,99565216,99565216,+,2233,612961,7:100178177,chr7,100178177,100178177,0.000579024,-0.0738734,0,0.02118986,100178177,rs35061193
678983,678983,ENSG00000143756,chr1,224301789,224301789,+,2997,-33993,1:224267796,chr1,224267796,224267796,4.01626e-07,0.0386163,0,3.102656e-05,224267796,rs6695935
679014,679014,ENSG00000143756,chr1,224301789,224301789,+,2997,-8010,1:224293779,chr1,224293779,224293779,2.8882e-06,0.0484752,0,0.0001908343,224293779,rs11807877
679035,679035,ENSG00000143756,chr1,224301789,224301789,+,2997,6501,1:224308290,chr1,224308290,224308290,0.000377619,0.0460633,0,0.01475365,224308290,rs138315830
679100,679100,ENSG00000143756,chr1,224301789,224301789,+,2997,58352,1:224360141,chr1,224360141,224360141,8.13098e-15,-0.0733465,0,1.551932e-12,224360141,rs6657195
679140,679140,ENSG00000143756,chr1,224301789,224301789,+,2997,105369,1:224407158,chr1,224407158,224407158,5.18087e-05,-0.0331999,0,0.002604095,224407158,rs11582572
679149,679149,ENSG00000143756,chr1,224301789,224301789,+,2997,123376,1:224425165,chr1,224425165,224425165,6.66437e-10,0.048558,0,7.687142e-08,224425165,rs12565875
679152,679152,ENSG00000143756,chr1,224301789,224301789,+,2997,220892,1:224522681,chr1,224522681,224522681,0.00129833,-0.0347729,0,0.04126993,224522681,rs61827768
699273,699273,ENSG00000133069,chr1,205197304,205197304,+,3380,-212154,1:204985150,chr1,204985150,204985150,1.66265e-07,-0.0819564,0,1.368579e-05,204985150,rs57364387
699291,699291,ENSG00000133069,chr1,205197304,205197304,+,3380,-156361,1:205040943,chr1,205040943,205040943,9.7142e-30,-0.120532,0,4.830277e-27,205040943,rs12117194
699539,699539,ENSG00000133069,chr1,205197304,205197304,+,3380,64713,1:205262017,chr1,205262017,205262017,2.26204e-14,0.0858471,0,4.138664e-12,205262017,rs10159465
759942,759942,ENSG00000124214,chr20,47804904,47804904,+,4026,-273659,20:47531245,chr20,47531245,47531245,0.00140536,-0.0329198,0,0.04398107,47531245,rs6019518
782836,782836,ENSG00000100335,chr22,39895437,39895437,+,2840,13307,22:39908744,chr22,39908744,39908744,1.11386e-05,0.0765247,0,0.0006533083,39908744,rs10854721
824092,824092,ENSG00000087258,chr16,56225302,56225302,+,4400,-739613,16:55485689,chr16,55485689,55485689,0.000848816,-0.0711377,0,0.02916665,55485689,rs72808996
825867,825867,ENSG00000182149,chr16,71879899,71879899,+,2855,-345551,16:71534348,chr16,71534348,71534348,2.04455e-08,-0.095827,0,1.934648e-06,71534348,rs7188299
825882,825882,ENSG00000182149,chr16,71879899,71879899,+,2855,-204763,16:71675136,chr16,71675136,71675136,0.000351063,-0.0600567,0,0.01386389,71675136,rs8058188
825914,825914,ENSG00000182149,chr16,71879899,71879899,+,2855,-41031,16:71838868,chr16,71838868,71838868,0.000998992,0.0566726,0,0.03335155,71838868,rs77139486
826002,826002,ENSG00000182149,chr16,71879899,71879899,+,2855,137007,16:72016906,chr16,72016906,72016906,0.00025193,-0.0533123,0,0.01042238,72016906,rs8063499
833006,833006,ENSG00000065427,chr16,75681563,75681563,+,4834,241281,16:75922844,chr16,75922844,75922844,5.69441e-05,-0.134689,0,0.002832625,75922844,rs7206731
872147,872147,ENSG00000147894,chr9,27573448,27573448,+,4684,-103875,9:27469573,chr9,27469573,27469573,4.65738e-22,0.117349,0,1.528138e-19,27469573,rs12552327
872193,872193,ENSG00000147894,chr9,27573448,27573448,+,4684,-65299,9:27508149,chr9,27508149,27508149,8.48429e-07,-0.0841839,0,6.196445e-05,27508149,rs2453564
872271,872271,ENSG00000147894,chr9,27573448,27573448,+,4684,-19260,9:27554188,chr9,27554188,27554188,6.27201e-10,0.0667988,0,7.260532e-08,27554188,rs10124158
872274,872274,ENSG00000147894,chr9,27573448,27573448,+,4684,-17612,9:27555836,chr9,27555836,27555836,1.91497e-05,-0.0445289,0,0.001066433,27555836,rs10967984
872339,872339,ENSG00000147894,chr9,27573448,27573448,+,4684,10611,9:27584059,chr9,27584059,27584059,7.683540000000001e-18,0.169081,0,1.879249e-15,27584059,rs34555425
872346,872346,ENSG00000147894,chr9,27573448,27573448,+,4684,14070,9:27587518,chr9,27587518,27587518,9.49639e-09,0.0655224,0,9.411986e-07,27587518,rs1932145
872355,872355,ENSG00000147894,chr9,27573448,27573448,+,4684,21142,9:27594590,chr9,27594590,27594590,7.88526e-11,-0.077781,0,1.017722e-08,27594590,rs2378030
883569,883569,ENSG00000107282,chr9,72287222,72287222,+,3721,-250842,9:72036380,chr9,72036380,72036380,0.000970937,-0.040183,0,0.03258118,72036380,rs932967
883592,883592,ENSG00000107282,chr9,72287222,72287222,+,3721,-159057,9:72128165,chr9,72128165,72128165,0.000148591,-0.0455421,0,0.006592679,72128165,rs12338371
892157,892157,ENSG00000159200,chr21,35893881,35893881,+,3295,61923,21:35955804,chr21,35955804,35955804,6.27945e-09,0.17438,0,6.37059e-07,35955804,rs2284601
892168,892168,ENSG00000159200,chr21,35893881,35893881,+,3295,72903,21:35966784,chr21,35966784,35966784,3.94642e-05,0.063314,0,0.002041436,35966784,rs2018742
892182,892182,ENSG00000159200,chr21,35893881,35893881,+,3295,101222,21:35995103,chr21,35995103,35995103,0.00104241,-0.0530646,0,0.03454095,35995103,rs7283162
895780,895780,ENSG00000119917,chr10,91087651,91087651,+,4396,-37365,10:91050286,chr10,91050286,91050286,1.50313e-05,-0.103269,1,0.0008566613,91050286,rs10887938
901342,901342,ENSG00000150593,chr10,112631565,112631565,+,3854,-461079,10:112170486,chr10,112170486,112170486,0.00113845,-0.0737533,0,0.03710253,112170486,rs766197
919645,919645,ENSG00000160307,chr21,48025121,48025121,+,2562,-342693,21:47682428,chr21,47682428,47682428,0.00145356,-0.041512,0,0.0451843,47682428,rs17176513
919693,919693,ENSG00000160307,chr21,48025121,48025121,+,2562,-296497,21:47728624,chr21,47728624,47728624,6.47761e-16,-0.196806,0,1.360892e-13,47728624,rs111758715
919929,919929,ENSG00000160307,chr21,48025121,48025121,+,2562,-67354,21:47957767,chr21,47957767,47957767,1.37186e-06,0.065764,0,9.641254e-05,47957767,rs721131
919989,919989,ENSG00000160307,chr21,48025121,48025121,+,2562,-13111,21:48012010,chr21,48012010,48012010,2.9579e-06,0.0612113,0,0.0001950513,48012010,rs9978010
920009,920009,ENSG00000160307,chr21,48025121,48025121,+,2562,2099,21:48027220,chr21,48027220,48027220,8.4542e-05,0.0693115,0,0.004017204,48027220,rs73379600
920014,920014,ENSG00000160307,chr21,48025121,48025121,+,2562,5699,21:48030820,chr21,48030820,48030820,7.55573e-05,0.0746991,0,0.003637669,48030820,rs72613658
920036,920036,ENSG00000160307,chr21,48025121,48025121,+,2562,20968,21:48046089,chr21,48046089,48046089,3.59844e-14,0.0980632,0,6.461282e-12,48046089,rs9980266
920052,920052,ENSG00000160307,chr21,48025121,48025121,+,2562,30481,21:48055602,chr21,48055602,48055602,0.000570798,0.0911722,0,0.02093665,48055602,rs2277829
920064,920064,ENSG00000160307,chr21,48025121,48025121,+,2562,72489,21:48097610,chr21,48097610,48097610,2.95885e-08,-0.0765434,0,2.736533e-06,48097610,rs12626290
927038,927038,ENSG00000107816,chr10,102756375,102756375,+,2794,7716,10:102764091,chr10,102764091,102764091,0.00104551,0.079732,1,0.03462502,102764091,rs111644425
1007941,1007941,ENSG00000197386,chr4,3076408,3076408,+,3561,314889,4:3391297,chr4,3391297,3391297,0.00157086,-0.04059,0,0.04808095,3391297,rs1543787
1079955,1079955,ENSG00000102606,chr13,111766906,111766906,+,4335,192917,13:111959823,chr13,111959823,111959823,0.000597893,0.0483297,0,0.02176903,111959823,rs4773343
1100059,1100059,ENSG00000137845,chr15,59042177,59042177,+,3866,-177418,15:58864759,chr15,58864759,58864759,0.000371378,-0.0325757,0,0.01454563,58864759,rs34276094
1100161,1100161,ENSG00000137845,chr15,59042177,59042177,+,3866,63601,15:59105778,chr15,59105778,59105778,7.00882e-06,-0.0445731,0,0.0004289581,59105778,rs347112
1100238,1100238,ENSG00000137845,chr15,59042177,59042177,+,3866,240499,15:59282676,chr15,59282676,59282676,0.000452032,-0.0806185,0,0.01719403,59282676,rs150300673
1105506,1105506,ENSG00000166664,chr15,30685752,30685752,+,2691,599670,15:31285422,chr15,31285422,31285422,4.27854e-05,0.13372,0,0.002194606,31285422,rs1425292
1105524,1105524,ENSG00000166664,chr15,30685752,30685752,+,2691,618935,15:31304687,chr15,31304687,31304687,0.000401879,-0.178114,0,0.01555741,31304687,rs73368444
1105530,1105530,ENSG00000166664,chr15,30685752,30685752,+,2691,623716,15:31309468,chr15,31309468,31309468,8.90003e-06,0.149592,0,0.0005330609,31309468,rs12898815
1105572,1105572,ENSG00000166664,chr15,30685752,30685752,+,2691,871649,15:31557401,chr15,31557401,31557401,7.1641e-07,-0.233183,0,5.300204e-05,31557401,rs746083
1109726,1109726,ENSG00000175344,chr15,32322691,32322691,+,2934,188235,15:32510926,chr15,32510926,32510926,5.99873e-05,-0.104394,0,0.0029666,32510926,rs2926501
1109734,1109734,ENSG00000175344,chr15,32322691,32322691,+,2934,193556,15:32516247,chr15,32516247,32516247,0.00149742,-0.0960261,0,0.04626885,32516247,rs112100136
1120427,1120427,ENSG00000064726,chr15,83736106,83736106,+,2205,-507294,15:83228812,chr15,83228812,83228812,1.42602e-07,-0.0442535,0,1.186347e-05,83228812,rs28493687
1120572,1120572,ENSG00000064726,chr15,83736106,83736106,+,2205,-284937,15:83451169,chr15,83451169,83451169,1.3454e-09,-0.0628549,0,1.492054e-07,83451169,rs7172538
1120604,1120604,ENSG00000064726,chr15,83736106,83736106,+,2205,-231528,15:83504578,chr15,83504578,83504578,6.90985e-06,-0.0468654,0,0.0004234496,83504578,rs35946485
1120661,1120661,ENSG00000064726,chr15,83736106,83736106,+,2205,-161081,15:83575025,chr15,83575025,83575025,1.08033e-17,0.092472,0,2.613584e-15,83575025,rs12385964
1120675,1120675,ENSG00000064726,chr15,83736106,83736106,+,2205,-147211,15:83588895,chr15,83588895,83588895,4.1451e-20,-0.07546,0,1.194548e-17,83588895,rs12148275
1120765,1120765,ENSG00000064726,chr15,83736106,83736106,+,2205,39709,15:83775815,chr15,83775815,83775815,1.60494e-19,-0.0913468,0,4.445901000000001e-17,83775815,rs10152258
1120770,1120770,ENSG00000064726,chr15,83736106,83736106,+,2205,53802,15:83789908,chr15,83789908,83789908,2.06482e-30,-0.200774,0,1.061125e-27,83789908,rs4843071
1120797,1120797,ENSG00000064726,chr15,83736106,83736106,+,2205,112777,15:83848883,chr15,83848883,83848883,1.80865e-11,0.0671374,0,2.503878e-09,83848883,rs17158063
1120907,1120907,ENSG00000064726,chr15,83736106,83736106,+,2205,280811,15:84016917,chr15,84016917,84016917,6.24063e-05,0.0348684,0,0.0030727,84016917,rs10152984
1120920,1120920,ENSG00000064726,chr15,83736106,83736106,+,2205,329846,15:84065952,chr15,84065952,84065952,3.80177e-06,0.0397981,0,0.0002453821,84065952,rs301845
1120921,1120921,ENSG00000064726,chr15,83736106,83736106,+,2205,338390,15:84074496,chr15,84074496,84074496,1.39426e-08,-0.0504689,0,1.350666e-06,84074496,rs60425303
1120926,1120926,ENSG00000064726,chr15,83736106,83736106,+,2205,343183,15:84079289,chr15,84079289,84079289,5.30672e-08,-0.0458811,0,4.731553e-06,84079289,rs2399140
1120945,1120945,ENSG00000064726,chr15,83736106,83736106,+,2205,395883,15:84131989,chr15,84131989,84131989,4.20417e-09,0.0498368,0,4.367989e-07,84131989,rs28521508
1120962,1120962,ENSG00000064726,chr15,83736106,83736106,+,2205,428812,15:84164918,chr15,84164918,84164918,9.70101e-10,-0.0887411,0,1.095488e-07,84164918,rs111664929
1120994,1120994,ENSG00000064726,chr15,83736106,83736106,+,2205,524362,15:84260468,chr15,84260468,84260468,0.000686547,0.0703643,0,0.0244446,84260468,rs12902037
1141447,1141447,ENSG00000168958,chr2,228189867,228189867,+,4422,44432,2:228234299,chr2,228234299,228234299,3.04393e-16,0.343793,0,6.574397e-14,228234299,rs113353261
1141461,1141461,ENSG00000168958,chr2,228189867,228189867,+,4422,50177,2:228240044,chr2,228240044,228240044,6.7161e-18,0.178276,0,1.650096e-15,228240044,rs10178861
1141463,1141463,ENSG00000168958,chr2,228189867,228189867,+,4422,50633,2:228240500,chr2,228240500,228240500,5.844159999999999e-20,-0.256233,0,1.6690360000000006e-17,228240500,rs12472653
1141500,1141500,ENSG00000168958,chr2,228189867,228189867,+,4422,75583,2:228265450,chr2,228265450,228265450,7.53452e-06,-0.0949274,0,0.0004581275,228265450,rs13031474
1141505,1141505,ENSG00000168958,chr2,228189867,228189867,+,4422,77042,2:228266909,chr2,228266909,228266909,1.78814e-06,-0.0979487,0,0.0001229715,228266909,rs11891024
1149593,1149593,ENSG00000084764,chr2,27193480,27193480,+,2343,-244114,2:26949366,chr2,26949366,26949366,0.000526196,0.0229,0,0.01955087,26949366,rs935166
1149692,1149692,ENSG00000084764,chr2,27193480,27193480,+,2343,76034,2:27269514,chr2,27269514,27269514,5.54094e-05,0.0543595,0,0.002764771,27269514,rs4665940
1191124,1191124,ENSG00000101558,chr18,9913999,9913999,+,4462,63597,18:9977596,chr18,9977596,9977596,0.00105896,-0.0642756,0,0.03498863,9977596,rs149668998
1197363,1197363,ENSG00000136717,chr2,127864577,127864577,+,4341,19546,2:127884123,chr2,127884123,127884123,0.00103139,-0.0291085,0,0.03424172,127884123,rs7575209
1203614,1203614,ENSG00000003393,chr2,202645912,202645912,+,2523,-484625,2:202161287,chr2,202161287,202161287,1.72805e-05,-0.0773954,0,0.0009719855,202161287,rs2349072
1204943,1204943,ENSG00000163596,chr2,203736365,203736365,+,2388,-703983,2:203032382,chr2,203032382,203032382,0.000396277,-0.0925051,0,0.01537225,203032382,rs75324624
1205002,1205002,ENSG00000163596,chr2,203736365,203736365,+,2388,-125535,2:203610830,chr2,203610830,203610830,1.90557e-05,-0.0395074,0,0.001061723,203610830,rs7589458
1205113,1205113,ENSG00000163596,chr2,203736365,203736365,+,2388,12421,2:203748786,chr2,203748786,203748786,0.000509523,0.0400848,0,0.01902555,203748786,rs112065260
1205311,1205311,ENSG00000163596,chr2,203736365,203736365,+,2388,384698,2:204121063,chr2,204121063,204121063,8.08559e-24,-0.131216,0,2.964535e-21,204121063,rs72938315
1207776,1207776,ENSG00000221823,chr2,68479663,68479663,+,4311,-139217,2:68340446,chr2,68340446,68340446,0.00143424,-0.028185,0,0.04470525,68340446,rs13401870
1207780,1207780,ENSG00000221823,chr2,68479663,68479663,+,4311,-126369,2:68353294,chr2,68353294,68353294,6.51349e-05,-0.036537,0,0.003191367,68353294,rs62145925
1211063,1211063,ENSG00000171055,chr2,36805975,36805975,+,4859,-161824,2:36644151,chr2,36644151,36644151,2.11997e-06,-0.169059,0,0.0001437695,36644151,rs75097300
1211078,1211078,ENSG00000171055,chr2,36805975,36805975,+,4859,-95196,2:36710779,chr2,36710779,36710779,2.92514e-07,-0.0875599,0,2.312678e-05,36710779,rs11692416
1211136,1211136,ENSG00000171055,chr2,36805975,36805975,+,4859,-8429,2:36797546,chr2,36797546,36797546,1.34736e-05,0.139679,0,0.0007758867,36797546,rs76259623
1211184,1211184,ENSG00000171055,chr2,36805975,36805975,+,4859,16343,2:36822318,chr2,36822318,36822318,7.20944e-18,0.146964,0,1.767145e-15,36822318,rs7560321
1211198,1211198,ENSG00000171055,chr2,36805975,36805975,+,4859,24343,2:36830318,chr2,36830318,36830318,5.10845e-05,-0.0993145,0,0.002571663,36830318,rs58657277
1211199,1211199,ENSG00000171055,chr2,36805975,36805975,+,4859,26537,2:36832512,chr2,36832512,36832512,1.21688e-30,-0.17005,0,6.334199e-28,36832512,rs6756508
1211225,1211225,ENSG00000171055,chr2,36805975,36805975,+,4859,50865,2:36856840,chr2,36856840,36856840,3.35108e-14,0.122132,0,6.034152e-12,36856840,rs56115305
1211226,1211226,ENSG00000171055,chr2,36805975,36805975,+,4859,50927,2:36856902,chr2,36856902,36856902,0.00153559,0.0516267,0,0.04721473,36856902,rs60512518
1211233,1211233,ENSG00000171055,chr2,36805975,36805975,+,4859,69205,2:36875180,chr2,36875180,36875180,0.000796536,0.115111,0,0.0276656,36875180,rs75799731
1211266,1211266,ENSG00000171055,chr2,36805975,36805975,+,4859,139899,2:36945874,chr2,36945874,36945874,0.00163186,-0.0637524,0,0.04957064,36945874,rs1861388
1233467,1233467,ENSG00000134046,chr18,51751158,51751158,+,4426,-62321,18:51688837,chr18,51688837,51688837,0.00023081,-0.0853747,0,0.00966307,51688837,rs73481716
1233480,1233480,ENSG00000134046,chr18,51751158,51751158,+,4426,25685,18:51776843,chr18,51776843,51776843,4.53622e-05,-0.0786987,0,0.002312728,51776843,rs2610525
1271119,1271119,ENSG00000080815,chr14,73603126,73603126,+,4283,116208,14:73719334,chr14,73719334,73719334,0.000850805,0.0451434,0,0.02922299,73719334,rs2242611
1293298,1293298,ENSG00000066044,chr19,8070492,8070492,+,4538,265434,19:8335926,chr19,8335926,8335926,0.000785776,-0.0416379,0,0.02735473,8335926,rs422783
1321108,1321108,ENSG00000196263,chr19,57019212,57019212,+,4577,29028,19:57048240,chr19,57048240,57048240,4.99894e-06,-0.0785074,0,0.000315175,57048240,rs917406
1321175,1321175,ENSG00000196263,chr19,57019212,57019212,+,4577,79738,19:57098950,chr19,57098950,57098950,7.21523e-07,-0.0698802,0,5.335146e-05,57098950,rs10406660
1337859,1337859,ENSG00000183386,chr1,38471174,38471174,+,3420,-685777,1:37785397,chr1,37785397,37785397,6.29412e-05,-0.0888289,0,0.003095886,37785397,rs6684832
1337920,1337920,ENSG00000183386,chr1,38471174,38471174,+,3420,-62101,1:38409073,chr1,38409073,38409073,0.0016261,-0.0450011,0,0.04943083,38409073,rs28673728
1337929,1337929,ENSG00000183386,chr1,38471174,38471174,+,3420,-35143,1:38436031,chr1,38436031,38436031,7.90671e-05,0.0994246,0,0.003786506,38436031,rs61776713
1353802,1353802,ENSG00000182318,chr19,58838385,58838385,+,2252,47457,19:58885842,chr19,58885842,58885842,0.000515131,0.123863,0,0.01920225,58885842,rs6510142
1354150,1354150,ENSG00000174586,chr19,58874120,58874120,+,2163,12461,19:58886581,chr19,58886581,58886581,2.10691e-08,0.0888438,0,1.989994e-06,58886581,rs10460168
1354173,1354173,ENSG00000174586,chr19,58874120,58874120,+,2163,132390,19:59006510,chr19,59006510,59006510,0.00132642,0.0549445,0,0.04198542,59006510,rs10415547
1403530,1403530,ENSG00000114503,chr3,196664561,196664561,+,4252,-63954,3:196600607,chr3,196600607,196600607,1.19815e-41,-0.16121,1,9.858169999999999e-39,196600607,rs4916570
1403638,1403638,ENSG00000114503,chr3,196664561,196664561,+,4252,3608,3:196668169,chr3,196668169,196668169,3.42924e-14,-0.115107,0,6.16943e-12,196668169,rs9873040
1403643,1403643,ENSG00000114503,chr3,196664561,196664561,+,4252,9746,3:196674307,chr3,196674307,196674307,2.04366e-06,-0.128665,0,0.0001390152,196674307,rs17855662
1419984,1419984,ENSG00000169087,chr3,122460623,122460623,+,3503,-286219,3:122174404,chr3,122174404,122174404,0.00152771,-0.0836515,0,0.04702008,122174404,rs11705725
1420006,1420006,ENSG00000169087,chr3,122460623,122460623,+,3503,-89564,3:122371059,chr3,122371059,122371059,2.73706e-09,-0.101911,0,2.915981e-07,122371059,rs10934608
1420025,1420025,ENSG00000169087,chr3,122460623,122460623,+,3503,-83426,3:122377197,chr3,122377197,122377197,4.05208e-06,-0.0661915,0,0.0002600947,122377197,rs1271034
1420382,1420382,ENSG00000169087,chr3,122460623,122460623,+,3503,192907,3:122653530,chr3,122653530,122653530,1.60587e-05,0.128583,0,0.0009096082,122653530,rs74634814
1420394,1420394,ENSG00000169087,chr3,122460623,122460623,+,3503,200369,3:122660992,chr3,122660992,122660992,9.72174e-06,-0.116474,0,0.0005775614,122660992,rs6801284
1420399,1420399,ENSG00000169087,chr3,122460623,122460623,+,3503,294196,3:122754819,chr3,122754819,122754819,5.20539e-05,-0.0859956,0,0.002615127,122754819,rs73195646
1433558,1433558,ENSG00000172020,chr3,115342171,115342171,+,3211,99074,3:115441245,chr3,115441245,115441245,5.24283e-07,0.048896,1,3.972133e-05,115441245,rs6438278
1440813,1440813,ENSG00000005884,chr17,48133332,48133332,+,3045,131,17:48133463,chr17,48133463,48133463,2.5555e-05,-0.0810773,0,0.001382786,48133463,rs16970080
1440851,1440851,ENSG00000005884,chr17,48133332,48133332,+,3045,67502,17:48200834,chr17,48200834,48200834,2.55796e-05,-0.0970404,0,0.001383969,48200834,rs847685
1446900,1446900,ENSG00000177885,chr17,73317834,73317834,+,3203,209754,17:73527588,chr17,73527588,73527588,5.23658e-05,0.0801062,0,0.002629161,73527588,rs7502310
1465856,1465856,ENSG00000023191,chr11,503570,503570,+,3113,-66511,11:437059,chr11,437059,437059,2.13345e-12,0.080254,0,3.252024e-10,437059,rs11600020
1466009,1466009,ENSG00000023191,chr11,503570,503570,+,3113,22214,11:525784,chr11,525784,525784,0.000224041,-0.0407148,0,0.009417751,525784,rs4963205
1466015,1466015,ENSG00000023191,chr11,503570,503570,+,3113,23741,11:527311,chr11,527311,527311,0.000143255,0.099643,0,0.006384735,527311,rs117011293
1466062,1466062,ENSG00000023191,chr11,503570,503570,+,3113,44373,11:547943,chr11,547943,547943,9.66662e-05,-0.0563854,0,0.004521293,547943,rs57338467
1466074,1466074,ENSG00000023191,chr11,503570,503570,+,3113,61747,11:565317,chr11,565317,565317,4.57776e-05,0.0761938,0,0.002331573,565317,rs116255671
1466160,1466160,ENSG00000023191,chr11,503570,503570,+,3113,140166,11:643736,chr11,643736,643736,2.56428e-05,-0.058389,0,0.001387024,643736,rs36180797
1466168,1466168,ENSG00000023191,chr11,503570,503570,+,3113,143825,11:647395,chr11,647395,647395,0.000209895,0.0463778,0,0.008900693,647395,rs7122043
1466222,1466222,ENSG00000023191,chr11,503570,503570,+,3113,198153,11:701723,chr11,701723,701723,9.30386e-05,-0.0532443,0,0.004371748,701723,rs10902200
1466226,1466226,ENSG00000023191,chr11,503570,503570,+,3113,202060,11:705630,chr11,705630,705630,0.000564099,-0.0371639,0,0.02072902,705630,rs12804878
1466250,1466250,ENSG00000023191,chr11,503570,503570,+,3113,275287,11:778857,chr11,778857,778857,0.000851279,-0.0741207,0,0.02923666,778857,rs61876729
1466290,1466290,ENSG00000023191,chr11,503570,503570,+,3113,538397,11:1041967,chr11,1041967,1041967,0.000500988,0.049051,0,0.0187563,1041967,rs72842424
1482204,1482204,ENSG00000186868,chr17,43971932,43971932,+,1651,-912171,17:43059761,chr17,43059761,43059761,1.81789e-07,-0.124444,0,1.487354e-05,43059761,rs78046226
1482229,1482229,ENSG00000186868,chr17,43971932,43971932,+,1651,-854351,17:43117581,chr17,43117581,43117581,2.27093e-07,-0.0664937,0,1.829043e-05,43117581,rs113644109
1482279,1482279,ENSG00000186868,chr17,43971932,43971932,+,1651,-783815,17:43188117,chr17,43188117,43188117,6.55331e-07,0.0654498,0,4.880544e-05,43188117,rs12948326
1482281,1482281,ENSG00000186868,chr17,43971932,43971932,+,1651,-782573,17:43189359,chr17,43189359,43189359,8.56942e-07,-0.0798395,0,6.254065e-05,43189359,rs5026009
1482289,1482289,ENSG00000186868,chr17,43971932,43971932,+,1651,-763864,17:43208068,chr17,43208068,43208068,2.10924e-17,-0.221189,0,4.988344e-15,43208068,rs77403959
1482331,1482331,ENSG00000186868,chr17,43971932,43971932,+,1651,-637283,17:43334649,chr17,43334649,43334649,3.68864e-07,-0.0627088,0,2.867315e-05,43334649,rs60163605
1501346,1501346,ENSG00000108797,chr17,40834631,40834631,+,2425,-268168,17:40566463,chr17,40566463,40566463,0.000199755,-0.0309958,0,0.008526086,40566463,rs12600758
1501435,1501435,ENSG00000108797,chr17,40834631,40834631,+,2425,-116959,17:40717672,chr17,40717672,40717672,0.00116575,0.0582417,0,0.03782342,40717672,rs74886553
1503135,1503135,ENSG00000188554,chr17,41322498,41322498,+,2746,-238748,17:41083750,chr17,41083750,41083750,0.00134171,-0.0820955,0,0.04237402,41083750,rs137897543
1503477,1503477,ENSG00000188554,chr17,41322498,41322498,+,2746,121149,17:41443647,chr17,41443647,41443647,1.92024e-05,-0.148915,0,0.001069052,41443647,rs147832718
1510026,1510026,ENSG00000186318,chr11,117186972,117186972,+,4578,-84266,11:117102706,chr11,117102706,117102706,0.000520142,0.0547255,0,0.0193604,117102706,rs2277286
1510037,1510037,ENSG00000186318,chr11,117186972,117186972,+,4578,-66499,11:117120473,chr11,117120473,117120473,0.000572862,0.0295725,0,0.02100003,117120473,rs509565
1510102,1510102,ENSG00000186318,chr11,117186972,117186972,+,4578,707646,11:117894618,chr11,117894618,117894618,0.000243179,0.0551758,0,0.01010963,117894618,rs56340594
1521484,1521484,ENSG00000108219,chr10,82213922,82213922,+,5376,664,10:82214586,chr10,82214586,82214586,5.39071e-10,0.0955962,0,6.291624e-08,82214586,rs7098414
1521489,1521489,ENSG00000108219,chr10,82213922,82213922,+,5376,19303,10:82233225,chr10,82233225,82233225,5.63489e-06,0.0620037,0,0.0003516782,82233225,rs10788639
1537144,1537144,ENSG00000177697,chr11,832843,832843,+,3978,-131120,11:701723,chr11,701723,701723,4.5489e-05,0.0655375,0,0.002318418,701723,rs10902200
1537192,1537192,ENSG00000177697,chr11,832843,832843,+,3978,-14703,11:818140,chr11,818140,818140,1.24605e-05,0.0812171,0,0.0007231014,818140,rs34284803
1537194,1537194,ENSG00000177697,chr11,832843,832843,+,3978,-5130,11:827713,chr11,827713,827713,1.18471e-05,0.0664636,0,0.000690886,827713,rs61876746
1537221,1537221,ENSG00000177697,chr11,832843,832843,+,3978,16860,11:849703,chr11,849703,849703,2.92308e-05,-0.0848457,0,0.001560117,849703,rs61867549
1537223,1537223,ENSG00000177697,chr11,832843,832843,+,3978,18371,11:851214,chr11,851214,851214,0.000271157,0.122549,0,0.01110421,851214,rs11246332
1537237,1537237,ENSG00000177697,chr11,832843,832843,+,3978,37681,11:870524,chr11,870524,870524,2.78188e-05,0.0728213,0,0.001492267,870524,rs10466744
1537258,1537258,ENSG00000177697,chr11,832843,832843,+,3978,62031,11:894874,chr11,894874,894874,4.48837e-05,-0.0523776,0,0.002290854,894874,rs34360522
1537281,1537281,ENSG00000177697,chr11,832843,832843,+,3978,161064,11:993907,chr11,993907,993907,0.00115503,0.0699885,0,0.03754192,993907,rs11538725
1537290,1537290,ENSG00000177697,chr11,832843,832843,+,3978,209124,11:1041967,chr11,1041967,1041967,1.72819e-05,-0.0713871,0,0.0009720583,1041967,rs72842424
1537301,1537301,ENSG00000177697,chr11,832843,832843,+,3978,597947,11:1430790,chr11,1430790,1430790,8.93422e-05,0.0572128,0,0.004217686,1430790,rs7115782
1548473,1548473,ENSG00000166266,chr11,107879459,107879459,+,3900,127007,11:108006466,chr11,108006466,108006466,1.03548e-08,0.0401482,0,1.0209e-06,108006466,rs1550608
1548499,1548499,ENSG00000166266,chr11,107879459,107879459,+,3900,387396,11:108266855,chr11,108266855,108266855,0.000417613,-0.028683,0,0.01607462,108266855,rs7101497
1553379,1553379,ENSG00000109971,chr11,122932497,122932497,+,4047,-889905,11:122042592,chr11,122042592,122042592,0.00152946,-0.0549079,0,0.04706227,122042592,rs144670557
1628442,1628442,ENSG00000010810,chr6,112194270,112194270,+,3365,-210452,6:111983818,chr6,111983818,111983818,0.000191737,-0.0551478,0,0.008228412,111983818,rs9320374
1628462,1628462,ENSG00000010810,chr6,112194270,112194270,+,3365,-94473,6:112099797,chr6,112099797,112099797,4.68641e-05,-0.0580227,0,0.002381081,112099797,rs9487714
1628495,1628495,ENSG00000010810,chr6,112194270,112194270,+,3365,13760,6:112208030,chr6,112208030,112208030,3.61998e-07,-0.072294,1,2.817926e-05,112208030,rs9398292
1637194,1637194,ENSG00000198087,chr6,47445525,47445525,+,3800,-35697,6:47409828,chr6,47409828,47409828,1.23658e-05,-0.059028,0,0.000718153,47409828,rs12197146
1671769,1671769,ENSG00000095970,chr6,41130841,41130841,+,4260,79156,6:41209997,chr6,41209997,41209997,0.000353816,-0.0473712,0,0.01395699,41209997,rs972223
1699208,1699208,ENSG00000034693,chr6,143771944,143771944,+,3387,61542,6:143833486,chr6,143833486,143833486,8.32901e-06,0.0759326,0,0.000501865,143833486,rs686064
1811231,1811231,ENSG00000162714,chr1,247477154,247477154,+,5210,-35398,1:247441756,chr1,247441756,247441756,5.22437e-09,0.104049,0,5.357567e-07,247441756,rs12081945
1811280,1811280,ENSG00000162714,chr1,247477154,247477154,+,5210,11584,1:247488738,chr1,247488738,247488738,0.000183904,-0.130607,0,0.007935281,247488738,rs78594750
1811284,1811284,ENSG00000162714,chr1,247477154,247477154,+,5210,30444,1:247507598,chr1,247507598,247507598,0.00010209,-0.109908,0,0.004742364,247507598,rs60859377
1830124,1830124,ENSG00000117475,chr1,169337208,169337208,+,4797,-250950,1:169086258,chr1,169086258,169086258,0.00142229,0.0397602,0,0.04440734,169086258,rs3820048
1830203,1830203,ENSG00000117475,chr1,169337208,169337208,+,4797,-21675,1:169315533,chr1,169315533,169315533,6.07193e-06,-0.0661188,0,0.0003765091,169315533,rs10919148
1830213,1830213,ENSG00000117475,chr1,169337208,169337208,+,4797,-3879,1:169333329,chr1,169333329,169333329,1.86865e-06,-0.0831259,0,0.0001280524,169333329,rs12057602
1830250,1830250,ENSG00000117475,chr1,169337208,169337208,+,4797,126088,1:169463296,chr1,169463296,169463296,4.15941e-06,0.128268,0,0.000266372,169463296,rs147474835
1833528,1833528,ENSG00000116396,chr1,110753965,110753965,+,3171,103699,1:110857664,chr1,110857664,110857664,1.13056e-06,-0.0420813,0,8.075227e-05,110857664,rs547370
1838701,1838701,ENSG00000159363,chr1,17338267,17338267,+,3985,-591379,1:16746888,chr1,16746888,16746888,0.00148335,0.0268494,0,0.04592215,16746888,rs11260753
1838707,1838707,ENSG00000159363,chr1,17338267,17338267,+,3985,-39771,1:17298496,chr1,17298496,17298496,1.67813e-05,0.0346061,0,0.0009465447,17298496,rs7513616
1856408,1856408,ENSG00000105607,chr19,13001840,13001840,+,3252,-124876,19:12876964,chr19,12876964,12876964,3.98673e-05,-0.0896624,0,0.002060155,12876964,rs897804
1856415,1856415,ENSG00000105607,chr19,13001840,13001840,+,3252,723,19:13002563,chr19,13002563,13002563,1.16192e-07,0.110799,0,9.8083e-06,13002563,rs2242517
1856433,1856433,ENSG00000105607,chr19,13001840,13001840,+,3252,32282,19:13034122,chr19,13034122,13034122,0.000355114,0.17389,0,0.0140009,13034122,rs73004683
1856435,1856435,ENSG00000105607,chr19,13001840,13001840,+,3252,34529,19:13036369,chr19,13036369,13036369,1.8968e-05,-0.214438,0,0.001057331,13036369,rs146062578
1856441,1856441,ENSG00000105607,chr19,13001840,13001840,+,3252,59610,19:13061450,chr19,13061450,13061450,4.06738e-16,-0.167432,0,8.694266e-14,13061450,rs2974753
1856442,1856442,ENSG00000105607,chr19,13001840,13001840,+,3252,60587,19:13062427,chr19,13062427,13062427,0.000428624,0.103558,0,0.01643531,13062427,rs45495792
1856446,1856446,ENSG00000105607,chr19,13001840,13001840,+,3252,76837,19:13078677,chr19,13078677,13078677,0.000239655,0.117914,0,0.009982331,13078677,rs59402764
1856447,1856447,ENSG00000105607,chr19,13001840,13001840,+,3252,149637,19:13151477,chr19,13151477,13151477,2.65826e-06,0.115963,0,0.0001769133,13151477,rs7508365
1856450,1856450,ENSG00000105607,chr19,13001840,13001840,+,3252,389446,19:13391286,chr19,13391286,13391286,0.00140344,-0.0692265,0,0.04393343,13391286,rs10417819
1910328,1910328,ENSG00000176994,chr17,18218624,18218624,+,2311,-177934,17:18040690,chr17,18040690,18040690,0.000123261,0.0484243,0,0.005596124,18040690,rs854784
1910418,1910418,ENSG00000176994,chr17,18218624,18218624,+,2311,-62249,17:18156375,chr17,18156375,18156375,5.64777e-11,0.0843533,0,7.409644e-09,18156375,rs2605140
1932409,1932409,ENSG00000151229,chr12,40499661,40499661,+,4028,-325499,12:40174162,chr12,40174162,40174162,0.000123997,-0.034604,0,0.00562526,40174162,rs12424789
1932514,1932514,ENSG00000151229,chr12,40499661,40499661,+,4028,91512,12:40591173,chr12,40591173,40591173,0.000211056,-0.0310166,0,0.008943188,40591173,rs1491922
1932539,1932539,ENSG00000188906,chr12,40590546,40590546,+,4037,-510791,12:40079755,chr12,40079755,40079755,0.000703442,-0.0675218,0,0.02494477,40079755,rs11613165
1932543,1932543,ENSG00000188906,chr12,40590546,40590546,+,4037,-416384,12:40174162,chr12,40174162,40174162,2.57548e-08,-0.0684981,0,2.402385e-06,40174162,rs12424789
1932583,1932583,ENSG00000188906,chr12,40590546,40590546,+,4037,-226622,12:40363924,chr12,40363924,40363924,0.000343708,0.0679744,0,0.01361438,40363924,rs11174536
1932589,1932589,ENSG00000188906,chr12,40590546,40590546,+,4037,-211762,12:40378784,chr12,40378784,40378784,5.71318e-08,0.0649486,0,5.069118e-06,40378784,rs28370628
1932663,1932663,ENSG00000188906,chr12,40590546,40590546,+,4037,-88821,12:40501725,chr12,40501725,40501725,0.000299253,0.0388006,0,0.01208647,40501725,rs7132203
1932866,1932866,ENSG00000188906,chr12,40590546,40590546,+,4037,627,12:40591173,chr12,40591173,40591173,9.22782e-20,0.10293,0,2.598355e-17,40591173,rs1491922
1932889,1932889,ENSG00000188906,chr12,40590546,40590546,+,4037,19339,12:40609885,chr12,40609885,40609885,7.57966e-07,0.090421,0,5.584509e-05,40609885,rs17443345
1932975,1932975,ENSG00000188906,chr12,40590546,40590546,+,4037,104549,12:40695095,chr12,40695095,40695095,2.01469e-08,-0.0587076,0,1.908151e-06,40695095,rs10878340
1933135,1933135,ENSG00000188906,chr12,40590546,40590546,+,4037,192357,12:40782903,chr12,40782903,40782903,3.68523e-05,0.0510995,0,0.001920042,40782903,rs3906866
1933366,1933366,ENSG00000188906,chr12,40590546,40590546,+,4037,240268,12:40830814,chr12,40830814,40830814,0.000752681,0.036318,0,0.02639035,40830814,rs12822353
1933518,1933518,ENSG00000188906,chr12,40590546,40590546,+,4037,372764,12:40963310,chr12,40963310,40963310,8.80127e-05,0.0419934,0,0.00416217,40963310,rs7978657
1933519,1933519,ENSG00000188906,chr12,40590546,40590546,+,4037,375794,12:40966340,chr12,40966340,40966340,3.02263e-06,-0.0691506,0,0.0001989443,40966340,rs11177283
1955307,1955307,ENSG00000136279,chr7,44084239,44084239,+,3313,-87998,7:43996241,chr7,43996241,43996241,4.51679e-16,-0.0926688,0,9.621855e-14,43996241,rs2527815
1955325,1955325,ENSG00000136279,chr7,44084239,44084239,+,3313,-61032,7:44023207,chr7,44023207,44023207,1.68586e-05,0.118319,0,0.0009504878,44023207,rs113330126
1955330,1955330,ENSG00000136279,chr7,44084239,44084239,+,3313,-16868,7:44067371,chr7,44067371,44067371,2.67024e-15,-0.0961628,0,5.324902e-13,44067371,rs2595667
1955345,1955345,ENSG00000136279,chr7,44084239,44084239,+,3313,45330,7:44129569,chr7,44129569,44129569,3.31396e-23,0.132985,0,1.1698189999999999e-20,44129569,rs6979833
1966422,1966422,ENSG00000205571,chr5,69345439,69345439,+,783,-962851,5:68382588,chr5,68382588,68382588,0.00141662,0.227127,0,0.04426546,68382588,rs338679
1966425,1966425,ENSG00000205571,chr5,69345439,69345439,+,783,-920404,5:68425035,chr5,68425035,68425035,0.000713472,0.118593,0,0.02523952,68425035,rs234262
2010473,2010473,ENSG00000185933,chr10,105218645,105218645,+,3104,-133454,10:105085191,chr10,105085191,105085191,0.000133196,0.0597154,0,0.00599038,105085191,rs4420190
2010497,2010497,ENSG00000185933,chr10,105218645,105218645,+,3104,3091,10:105221736,chr10,105221736,105221736,7.74447e-06,0.0577839,0,0.00046975,105221736,rs7900899
2094326,2094326,ENSG00000100599,chr14,92980118,92980118,+,4365,-25355,14:92954763,chr14,92954763,92954763,0.000262968,-0.0848666,0,0.01081399,92954763,rs6145444
2098152,2098152,ENSG00000051128,chr19,19049858,19049858,+,3320,-334704,19:18715154,chr19,18715154,18715154,0.00119337,-0.131332,0,0.03854656,18715154,rs72995445
2098153,2098153,ENSG00000051128,chr19,19049858,19049858,+,3320,-176826,19:18873032,chr19,18873032,18873032,0.000887548,-0.120287,0,0.0302608,18873032,rs72997389
2098155,2098155,ENSG00000051128,chr19,19049858,19049858,+,3320,-117494,19:18932364,chr19,18932364,18932364,0.000395369,-0.128501,0,0.01534281,18932364,rs139937745
2100537,2100537,ENSG00000108107,chr19,55896713,55896713,+,3286,4156,19:55900869,chr19,55900869,55900869,0.00045287,-0.0332579,0,0.01722104,55900869,rs12981911
2100546,2100546,ENSG00000108107,chr19,55896713,55896713,+,3286,13519,19:55910232,chr19,55910232,55910232,8.30752e-08,-0.071469,0,7.182295e-06,55910232,rs11673539
2111777,2111777,ENSG00000175166,chr3,184016497,184016497,+,4337,-842498,3:183173999,chr3,183173999,183173999,0.00163178,0.0379881,0,0.04956873,183173999,rs6794101
2111782,2111782,ENSG00000175166,chr3,184016497,184016497,+,4337,-77640,3:183938857,chr3,183938857,183938857,0.000948004,-0.0385267,0,0.03194452,183938857,rs4447797
2111786,2111786,ENSG00000175166,chr3,184016497,184016497,+,4337,14341,3:184030838,chr3,184030838,184030838,0.000207706,-0.0547281,0,0.008819667,184030838,rs34390533
